NO ./Images/bookshelf.xpm
SO ./Images/Bricks.xpm
EA ./Images/WaterF1.xpm
WE ./Images/Gold1.xpm
C 126  ,156 ,23
F 50   ,45,0

111111111111111
100000000000001
100000000000001
100101000000001
100000000000001
100000001000001
110000100000001
101000000010001
101000000010001
100010111100011
10000000000N101
100000000000101
100010000000001
111111111111111
