


NO   ./salut

C 5 ,  219 ,51
EA ./okokok
SO  ./qqqqqqqq


WE ./wuieh

F 51,   3,122


111111111
    10011111111111111
11111000N000000011
11100111111100001
1111111111111
1111111  11111111
11111111011111
11111111111111111