NO ./Images/Bricks.png
SO ./Images/Bricks.png
EA ./Images/Bricks.png
WE ./Images/Bricks.png
C 10,10,235
F 50   ,45,0

11111111111
1N00011111
1111111