NO ./Images/Bricks.png
SO ./Images/Bricks.png
EA ./Images/Bricks.png
WE ./Images/Bricks.png
C 10,10,235
F 50   ,45,0

11111111111
11111111101
11111N111111
111110111
11