NO ./Images/Bricks.png
SO ./Images/Bricks.png
EA ./Images/Bricks.png
WE ./Images/Bricks.png
C 10      ,10 ,23
F 50   ,45,0

1111111111
1000000001
1000000001
1000000001  1111111
10000N0001  111011
1000000001   111
1000000001
1000000001
1111111111
