NO ./Images/Bricks.png
SO ./Images/Bricks.png
EA ./Images/Bricks.png
WE ./Images/Bricks.png
C 10      ,10 ,23
F 50   ,45,0

111111111111111
100000000000001
100000000000001
100101000000001
100000000000001
100000001000001
110000100000001
101000000010001
101000000010001
100010111100011
100000000010101
1000N0000000101
100000000000101
100010000000001
111111111111111
