NO ./Images/bookshelf.xpm
SO ./Images/Bricks.xpm
EA ./Images/WaterF1.xpm
WE ./Images/Gold1.xpm

C 126  , 156 ,23
F 50   ,45,0

11111111111111
10000001000001
10000001000001
11100001000001
10000000000001
1000S000010001
10000000010001
10000011110001
10000000010001
10000000000001
10000000000001
10000000000001
10000000000001
10000000000001
10000000000001
11111111111111