NO ./Images/bookshelf.xpm
SO ./Images/Bricks.xpm
EA ./Images/WaterF1.xpm
WE ./Images/Gold1.xpm

C 26,161,199
F 107,75,85


11111111111
10000000001
10000000001
100000000011111
100000000000001
10000N000000001
100000000S00001
100000000011111
10000000001
10000000001
11111111111